6,6,6,6,6,6,6,6,6
7,7,7,7,7,7,7,7,7
8,8,8,8,8,8,8,8,8
9,9,9,9,9,9,9,9,9
0,0,0,0,0,0,0,0,0
