0,0,0,0,0,0,0,0,0
0,5,0,0,6,0,0,7,0
5,5,5,6,6,6,7,7,7
0,5,0,0,6,0,0,7,0
0,0,0,0,0,0,0,0,0
0,0,0,0,4,0,0,0,0
