4,4,4,4,4,4,4,4,4
3,4,3,4,3,4,4,3,3
2,3,2,3,2,3,3,2,2
1,2,1,2,1,2,1,2,1
0,0,0,0,0,0,0,0,0
