0,0,0,0,6,0,0,0,0
0,0,0,6,5,6,0,0,0
0,0,6,5,4,5,6,0,0
0,0,0,6,5,6,0,0,0
0,0,0,0,6,0,0,0,0
