9,8,8,8,8,8,8,8,9
0,9,8,7,7,7,8,9,0
0,0,9,8,7,8,9,0,0
0,0,0,9,8,9,0,0,0
0,0,0,0,9,0,0,0,0
