4,1,1,1,1,1,1,1,4
0,4,2,2,2,2,2,4,0
0,0,4,3,3,3,4,0,0
0,0,0,4,3,4,0,0,0
0,0,0,0,4,0,0,0,0
