0,6,0,0,6,0,0,6,0
6,7,6,6,7,6,6,7,6
0,6,0,0,6,0,0,6,0
0,0,3,0,0,0,3,0,0
0,0,0,0,0,0,0,0,0
