9,9,9,9,9,9,9,9,9
8,8,8,0,0,0,8,8,8
0,7,0,0,6,0,0,7,0
0,0,0,0,5,0,0,0,0
0,0,0,0,4,0,0,0,0
