3,2,3,2,3,2,3,2,3
2,1,2,1,2,1,2,1,2
0,0,0,0,3,0,0,0,0
0,0,0,3,4,3,0,0,0
0,0,0,0,3,0,0,0,0
